#####################
#+    #     #   #   #
##### # ### # # # ###
#     #   # # # #   #
# ####### # # ##### #
#   # #   # #       #
### # # ### ##### ###
#   #   #   #     # #
# # # ### ### ##### #
# #   #             S
#####################
