#####################
#+      #         # #
# ### ### ##### # # #
# #   #   #     #   #
### # # ### ####### #
#   # #   #   #     #
# ####### ### #######
# #   #   # #   #   #
# # # # ### ### # # #
#   #         #   #S#
#####################