#####################
#+    #   #         #
### ### # # ##### ###
#   #   #   #   #   #
# # # ####### # ### #
# # #     # # #     #
# ####### # # #######
# #     #   #   #   #
# # ### ### ### # # #
#     #       #   #S#
#####################