#####################
#+  #     #   #     #
# # ### ### # # # ###
# #     #   #   #   #
# ####### ######### #
#   #   #   # #     #
# # # # ### # # #####
# #   #   #   #     #
# ##### ##### ##### #
#     #           #S#
#####################