#####################
#+      #   #       #
# ### ### # # ##### #
# #   #   #   #   # #
### # # ####### # # #
#   # #     #   #   #
# ######### # #######
# #   #   # #   #   #
# # # # # # ### # # #
#   #   #     #   #S#
#####################