#####################
#+#   #           # #
# # # # # ####### # #
#   #   # #   #     #
# ####### # # ##### #
#     # #   # #   # #
##### # ##### # # # #
# #   #     #   # # #
# # ### ### ##### ###
#       #       #  S#
#####################